111111111
100000111
11000B011
111000011
1S0000001
100011001
100011001
1000000C1
111111111