111111111
1000C0001
1000B0001
1000S0001
111111111