111111111
100000S01
10CB00001
100000001
111111111