111111111
10C000001
100B00001
100000S01
111111111