11111111111111
11000111110011
11000000000001
11101111111001
1110100S001011
111010000B1001
10001101000001
100000C0111001
11001000111111
11111111111111