11111111
10000111
10110B01
10100101
10000101
10100001
1C0S1111
11111111