1111111111111111111
1111100011111111111
1111100B11111111111
1111100011111111111
1110000000111111111
1110101110111111111
1000101110111110001
100000000000S000001
11111011110101100C1
1111100000011111111
1111111111111111111